-----------------------------------------------------------------------------------------------------------------------------------------------------
-----------------------------------------------------------------------------------------------------------------------------------------------------
--P--------------------------------------------------------------------------------------------------------------------------------------------------
---P-------------------------------------------------------------------------------------------------------------------------------------------------
----P----------------------------------------------oo----------------------------------------------------------------------------PP------------------
-----P-----------------PPP------------------?-----XXXX-------------------o------------------------------------------------------PP-P-----------------
------P---------------PXX-P---------------------------------------------XXX-------------------------oo--------------------------P---PPPP-------------
----------------------P----P------------------------------------------------o------o-o----XXX------XXXX---------------------PPPP---XXXX-P------------
-------P---------PPPPPP-----P---o----ooo------E------PPXXXX--o---o---o------XXXX------------------------o----PP-------------PXXX---------P-----------
----------------PXXXXXX------P------------XXXXXX----PP-PPP--XXX-XXX-XXX------------PPPPP---P-----------XXX--PP-PPP----------P-------------PP---------
--------P-------P---------XXX-P-------PPPPP--------PP-----P-----------------------PXXXX-PPP-PPPP---PP------PP-----P---------P----------XXXX-P--------
------------PPPPP--------------P-----PXXXX-P---ooo-P-------P-----------------PP---P-----XXX-XXX-P--P-P-----P-------PPPPPPPPP-----------------P-------
---------P-PPXXXXX--------------P----P------PPPPPPP---------P---------------PP-PPPP--------------PP---PPPPP-------XXXXXXXXXXXX----------------P-----P
-----------P---------------------PPPPP---XXXXXXXXXX----------P--------------P--XXXX-------------XXX---XXXXX------------------------------------P--PP-
----------P---------------oo---XXXXXXX------------------------PPPPPPPPPPPPPP--------------------------------------------------------------------PPXX-
XXXXXXXXXXX--------------XXX--------------------------------XXXXXXXXXXXXXXXX-----------------------------------XXX-------------------------XXXXXXXXXX
