-----------------------------------------------------------------------------------------------------------------------------------------------------------------------------------------------------
-----------------------------------------------------------------------------------------------------------------------------------------------------------------------------------------------------
--P--------------------------------------------------------------------------------------------------------------------------------------------------------------------------------------------------
---P---------------------------------------------------------------------------------------------------------------------------------------------------------------------------------PP--------------
----P-------------------------------------------------------------------------------------------------------------------------------------------------------------------------------PP-PPP-----------
-----P------------------------------------------------------------------------------------------------------------------------------------------------------------------------------P--XX-P----------
------P---------------------------------------------------------------------------------------------------------------------------------------------------------------------------PP---XX--P---------
-------P-------------SSSS---------------------QQQQQ-----------SSSS--------SSSSS------SSSS-----------------------------?SSS-----------------------------------SSSSS---?------PP----PS---XX---P--------
--------P------------------------------------------------------------------------------------------------------PP---------PP-----------------------------------------------PP-PPP-P----XX----P-------
---------P-P----PPP-------------------------------------------------------------------------------------------PP-PPP-P---PP-PP--------------------------------------------PP-----PP----XX-----P------
----------P-P---PX-P------PP----------PPP-------------------------PPP--------------------------PPP-----------PP-----P-P--P-<>-P-------------------------------------------P-------P----XX------P-----
--------S?S--P-PEX--PS---PPXPPP------PP<>PP--E?QQQQ----------S---PP<>PP-QQQQ--QQQ-----PP------PP<>PP---------P-----<>--PP--[]--P------------------PPP-----S---E----------PE-------SS---XX-------P----
--------------PXXX---P--PP-X---P----PP-[]--P--------------------PP-[]--P-------------PP-P----PP-[]--P------PPE-----[]--<>--[]---P---PP-----------PPX-P-------------E----P<>------------XX--------P---
--------------XXXX----P-P--XX---P---P--[]---P-------------------P--[]---P------------P---P---P--[]---P-----P<>-----[]--[]--[]----P--P-P--------E-P-X--P-----------------P[]------------XX---------P-P
-------------XXXXX----EP---XX---EPPP---[]----PPPPPPPPPPPPPPPPPPP---[]----PPPPPPPPPPPP-----PPPE--[]----PPPPP-[]--E--[]--[]--[]-----PP---PPPPPPPPPP--X---PPPPPPPPPPPPPPPPPP[]E-----------XX--------X-P-
XXXXXXXXXXXXXXXXXXXXXXXXXXXXXXXXXXXXXXXXXXXXXXXXXXXXXXXXXXXXXXXXXXXXXXXXXXXXXXXXXXXXX----XXXXXXXXXX---XXXXXXXXXXXXXXXXXXXXXXXXXXXXXX---XXXXXXXXXX--XXXXXXXXXXXXXXXXXXXXXXXXXXXXXXXXXXXXXXXXXXXXXXXXXX
