------------------------------------------------------------------------------------------------------------------------------------------------------------------------------------------------------
------------------------------------------------------------------------------------------------------------------------------------------------------------------------------------------------------
--P---------------------------------------------------------------------------------------------------------------------------------------------------------------------------------------------------
---P--------------------------------------------------------------------------------------------------------------------------------------------------------------------------------------------------
----P-------------------------------------------------------------------------------------------------------------------------------------------------------------------------------------------------
-----P------------------------------------------------------------------------------------------------------------------------------------------------------------------------------------------------
------P-----------------------------------------------------------------------------------------------------------------------------------------------------------------------------------------------
-------P-----------------------------------------------------------------------------SSS------------------------------------------------------------------------------------------------XX------------
--------P---------------------------------PP------------------------------------------------------------------------------------------------------------E-------------------------------XX------------
---------P-------------------------------PP-P----------------------------------------------------------------------------------------------------------<>----------------------------PP-XX------------
----------P------------------------------P---P-------------------------------------PPPPPPP---------------------------------------------------PPPPPP----[]---------------------------PX--XX------------
-----------P---------------------------PP-----PPP------------------------------E---PXXXXX-P-------------------PPP----------------------------PXSSS-P---XX--------------------------PXX-PXX------------
------------P-------------------------P<>-----<>-P--E--------------------------E---PX------P-----------------PPX-P---------------------------PX-----P--------PPPP----------E----E-PXXX--XX------------
-------------P------------------------P[]-----[]--P--------------------------------PX-------P----------------P-X--P--------------------------PX------P-------P<>-P---------------PXXXX--P---------PP-P
----------E--EPPPPPPPPPPPPPPPPPPPPPPPPP[]-----[]---PPPPPPPPPPPPPPPPPPPPPPPPPPPPPPPP-X--------PPPPPPPPPPPPPPPP--X---PPPPPPPPPPPPPPPPPPPPPPPPPPEX-------PPPPPPP-[]--PPPPPPPPPPPPPPPXXXXX---PPPPPPPPPX-P-
XXXXXXXXXXXXXXXXXXXXXXXXXXXXXXXXXXXXXXXXXXXX--XXXXXXXXXXXXXXXXXXXXXXXXXXXXXXXXXXXXXXXXX----XXXXXXXXXXXXXXXXXX--XXXXXXXXXXXXXXXXXXXXXXXXXXXXXXXXXXXX---XXXXXXXXXXXXXXXXXXXXXXXXXXXXXXXXXXXXXXXXXXXXXXXX
