--------------------------------------------------------------------------------------------------------------------------------------------------------------------------------
--------------------------------------------------------------------------------------------------------------------------------------------------------------------------------
--P-----------------------------------------------------------------------------------------------------------------------------------------------------------------------------
---P----------------------------------------------------------------------------------------------------------------------------------------------------------------------------
----P-------------------------------------------------------------------------------------------------------------------------------------------?-------------------------------
-----P--------------------------------------------------------------------------------------------------------------------------------------------------------------P-----------
------P-------------------------------------------------------------------------E---------------------------------------------------------------------------------PP-P----------
-------P------------?SS-----------------------------------------------------SSSSSS----S----------------------------------------SSSSS-----------------------------PXX--P---------
--------P-----------------------------------------------------------------------------------------------------------------------------------------SS---PP-------PXXX---P--------
---------P----------------------------------------------------------------------------------------------PP--------------------------------------------PX-P-----PXXXX----P-------
----------P---------------------------------------------------------PP-------E--------------------------P-P---------------------E-------------SS-----PXX--P---PXXXXX-----P------
-----------P--------------------QQQQ-------------------SSXSS-------PP-PPP--SSSSSSS----PPP-------------PP---P-------------------SSSSS--PP------------PXXX---P-PXXXXXX------P-----
------------P----E---------------------------E--------------------PP-<>--P-----------P<>-P-----------P<>----PPP---------PPPP---------PX-P--------P-PXXXX----PXXXXXXX-------P----
-------------P------------------E---------------------------------P--[]---P----------P[]--P----------P[]----<>-P--------P<>-P--------PX--P-------PPXXXXX----XXXXXXXX--------PP-P
--------------PPPPPPPPPPPPPPPPPPPPPPPPPPPPPPPPPPPPPPPPPPPPPPPPPPPP---[]----PPPPPPPPPPP[]---PPPPPPPPPPP[]-E--[]--PPPPPPPP-[]--PPPPPPPPPX---PPPPPPP-XXXXXX---XXXXXXXXX--------X-P-
XXXXXXXXXXXXXXXXXXXXXXXXXXXXXXXXXXXXXXXXXXXXXXXXXXXXXXXXXXXXXXXXXX--XXXXXXXXXXXXXXXXXXXXXXXXXXXXXXXXXXXXXXXXXXXXXXXXXXXXXXXXXXXXXXXXXXXXXXXXXXXXX-XXXXXXXXXXXXXXXXXXXXXXXXXXXXXX
