------------------------------------------------------------------------------------------------------------------------------------------------------------------------------------------------------------------------------
------------------------------------------------------------------------------------------------------------------------------------------------------------------------------------------------------------------------------
--P---------------------------------------------------------------------------------------------------------------------------------------------------------------------------------------------------------------------------
---P--------------------------------------------------------------------------------------------------------------------------------------------------------------------------------------------------------------------------
----P-------------------------------------------------------------------------------------------------------------------------------------------------------------------------------------------------------------------------
-----P------------------------------------------------------------------------------------------------------------------------------------------------------------------------------------------------------------P-----------
------P---------------------------------------------------------------------------------------------------------------------------------------------------------------------------------------------------------PP-P----------
-------P----------Q--------------------------------------Q-Q-------------------------S-------------------------------------------------------QQQQ--------------------------------------------------------------PXX--P---------
--------P-----------------------------------------------------------------------------------------oooo----------oooo------------oooo--------------------------------------------------------------------------PXXX---P--------
---------P---------------------------------------------------------------------------------------------------------------------------------------------------------------------------------------------------PXXXX----P-------
----------P------------------------oo-----------------------------------------------------------------------PPP-------------PPP-----------------------------------------------------------------------------PXXXXX-----P------
-----------P--PPP-?---------------o--o-------------------Q-Q------------PP---------QQQQ---------PP---------PP<>PP----------PP<>PP----------QQ?SSQQQ-----------------------------------PP-------------------PXXXXXX---S--P-----
------------PP<>-P-------PP--------------------------------------------PP-P--------------------PX-P-------PP-[]--P--------PP-[]--P------------PP-----------PPPP--------PP----PP------PX-P-----------------PXXXXXXX-------P----
-------------P[]--P------P-P-------------------------------------------P---P-------------------PX--P------P--[]---P-------P--[]---P-----------P-P----------P<>-P-------P-P---P-P-----PX--P---------------PXXXXXXXX--------PP-P
-------------P[]---PPPPPP---PPPPPPPPPPPPPPPPPPPPPPPPPPPPPPPPPPPPPPPPPPP-----PPPPPPPPPPPPPPPPPPPPX---PPPPPP---[]----PPPPPPP---[]----PPPPPPPPPPP---PPPPPPPPPP-[]--PPPPPPP---PPP---PPPPPPX---PPPPPPPPPPPPPPPXXXXXXXXX--------X-P-
XXXXXXXXXXXXXXXXXXXXXXXXX--XXXXXXXXXXXXXXXXXXXXXXXXXXXXXXXXXXXXXXXXXXXX----XXXXXXXXXXXXXXXXXXXXXXXXXXXXXXXXXXXXXXXXXXXXXXXXXXXXXXXXXXXXXXXXXXX--XXXXXXXXXXXXXXXXXXXXXXX---XXX--XXXXXXXX--XXXXXXXXXXXXXXXXXXXXXXXXXXXXXXXXXXXXX
