----------------------------------------------------------------------------------------------------------------------------------------------------------------------------------------------------------
----------------------------------------------------------------------------------------------------------------------------------------------------------------------------------------------------------
--P-------------------------------------------------------------------------------------------------------------------------------------------------------------------------------------------------------
---P------------------------------------------------------------------------------------------------------------------------------------------------------------------------------------------------------
----P-----------------------------------------------------------------------------------------------------------------------------------------------------------------------------------------------------
-----P----------------------------------------------------------------------------------------------------------------------------------------------------------------------------------------P-----------
------P---------------------------------------------------------------------------E---------------------------------------------------------------------------------------------------------PP-P----------
-------P--------------Q-------------------PP------------------------------------SSSSSSSS---SSSQ--------------?-----------SSS----SQQS-------------------------------------------------------PXX--P---------
--------P--------------------------------PP-PPP-------------------------------------------------------------------------------------------PP-------------PP-------------------------------PXXX---P--------
---------P------------------------------PP-----P-------------------------------E----------------------------------------------------------P-P------------P-P-----------------------------PXXXX----P-------
----------P-----------------------------P-------P-------PPP-----S------------------------------------------------------------------------P---P---------PP---P---------------------------PXXXXX-----P------
-----------P----Q---S?SQS-------------PP------<>-P-----PP<>PP----------------S?S--------------S-----SS----Q--Q--Q-----S----------SS-----PX--X-P-------PXX--X-P----------SSQS---------P-PXXXXXX------P-----
------------P--------------PPPP------P<>------[]--P---PP-[]--P-------PP---------------PP-----------------------------------------------PXX--XX-P-----PXXX--XX-P---PPPP------------PPP-PXXXXXXX-------P----
-------------P-------------P<>-P-----P[]------[]---P--P--[]---P------P-P--------------P-P---------------------------------------------PXXX--XXX-P---PXXXX--XXX-P--P<>-P-----------P<>-XXXXXXXX--------PP-P
--------------PPPPPPPPPPPPP-[]--PPPPPP[]-E----[]----PP-E-[]----PPPPPP---PPPPPPPPPPPPPP---PPPPPPPPPPPPPPPPPPPPPPPPPPPPPPPPPPPPPPPPPPPPPXXXX--XXXX-PPPXXXXX--XXXX-PP-[]--PPPPPPPPPPP-[]XXXXXXXXX--------X-P-
XXXXXXXXXXXXXXXXXXXXXXXXXXXXXXXXXXXXXXXXXXXXXXXXXXXXXXXXXXXXXXXXXXXXX--XXXXXXXXXXXXXXX---XXXXXXXXXXXXXXXXXXXXXXXXXXXXXXXXXXXXXXXXXXXXXXXXXXXXXXXXXXXXXXXX--XXXXXXXXXXXXXXXXXXXXXXXXXXXXXXXXXXXXXXXXXXXXXXX
