-----------------------------------------------------------------------------------------------------------------------------------------------------------------------------------------------------------------------
-----------------------------------------------------------------------------------------------------------------------------------------------------------------------------------------------------------------------
--P--------------------------------------------------------------------------------------------------------------------------------------------------------------------------------------------------------------------
---P-------------------------------------------------------------------------------------------------------------------------------------------------------------------------------------------------------------------
----P------------------------------------------------------------------------------------------------------------------------------------------------------------------------------------------------------------------
--------------------o--------------------------------------------------------------------------------------------------------------------------------------------------------------------------------------------------
-----P----PP---------------------------------PP-------------------------------------PP-------------------------------------------------------------------------------------------------------------------PPPP----------
---------PP-P-----SSS-------E---------------PP-PPP------------SSSSS-----SSSSS--PP---P-P------PP------------E--S---SSSSSSSSS------------SS---SS-------------SSS-----E---------------------------------E--PXXX-P---------
------P-PP---P--PP--PP-----<>-------PP-----PP-----P-------E-------------------PP-PPP---P----PP-PPP--------<>------------------------------------------------------<>----------------PP-----------------PXXXX--P--------
--------P-----P-P-P-P-P----[]------PP-PPP--P-------PPP---<>-------------PP---PP---<>----P--PP-----P-------[]------------------------------------------PP----------[]-------P--------P-P-------------P-PXXXXX---P-------
-------P-------P---P---PPP-XXX----PP-----PP--------<>-P--[]------------PP-P--P----[]-----P-P------EP------[]---------PP---------PP---SS---------------P-PP--------[]----PPP-P-----PP---P-----------P-PXXXXXX----P------
-----SSS------<>---S---<>-P-------P------<>---SS---[]--P-XXX-----------P---PPS----[]------P------<>-P----SXXS-------PP-PPP------P-P--------SSS----PPPP-XX-PSSS----XXX---P<>--P--PP<>----PPP--------P<>XXXXXX-----P-----
--------------[]-------[]--P-PPPPP-------[]--------[]---P----PPPP---PPP----<>---E-[]-----<>------[]--PP------PPPP--PP-----P--PPP---PP------------PXX<>-XX--P------------P[]---PP<>[]----<>-P-------P[]XXXXXX------P--P-
--------------[]-------[]----P<><>-------[]--------[]----P---P<>-P--P<>----[]--<>-[]-----[]------[]-<>-P-----P<>-P-P-------P-P<>--<>-P--P-P-----PXXX[]-XXX--P-----------P[]---<>[][]----[]--P-----PX[]XXXXXX-------PP-P
--------------[]----E--[]---P-[][]-------[]--------[]-----PPP-[]--PP-[]----[]--[]-[]-----[]------[]-[]--PPPPP-[]--P---------P-[]--[]--PP-P-PPPPPXXXX[]-XXX---PPPPPPPPPPP-[]---[][][]----[]---PPPPPXX[]XXXXXX-------XX--
XXXXXXXXXXXXXXXXXXXXXXXXXXXXXXXXXXXXXXXXXXXXXXXXXXXXXXXXXXXXXXXXXXXXXXXXXXXXXXXXXXXXXXXXXXXXXXXXXXXXXXXXXXXXXXXXXXXXXX------XXXXXXXXXXXX-X-XXXXXXXX-XXXXXXXXXXXXXXXXXXXXXXXXXXXXXXXXXXXXXXXXXXXXXXXXXXXXXXXXXXXXXXXXXXX
