-----------------------------------------------------------------------------------------------------------------------------------------------------------------------------------------------------
-----------------------------------------------------------------------------------------------------------------------------------------------------------------------------------------------------
--P--------------------------------------------------------------------------------------------------------------------------------------------------------------------------------------------------
---P-------------------------------------------------------------------------------------------------------------------------------------------------------------------------------------------------
----P--------------------------------------------------------------------------------------------------------------------------------------------------------------------------------------------E---
-----P-----------------------------------------------------------------------------------------------------------------------------------------------------------------------------------------------
------P-----------------------------------------------------------------------------------------------------------------------------------------E--------------------------------------PPPP----------
-------P-----------------------------------------------------------------PPS-------SSS------------------SSQSSS?SSS--------SSS------------------SQS--SQS-------------------P----------PPXXX-P---------
--------P---------------------------------------------------------------PP-PPP--------------------------------------------------------PPP-------------------------------PP-P---------PXXXX--P--------
---------P-------------------------------------------------------------PP-----P-P----------------------------------------------------PXX-P-----------------------o-----PXX--P-------PEXXXX---P-------
----------P-Q--?----------------E------------------------------------PPP--E-EE-P-PPP-------------E------------------------SSS-------PXXX--P-----------------------E----PXX---P-----PXXXXXX----P------
---------Q-P------ESSS----E----<>------------------E--S-------------PXP-------XX-XX-P-----------<>------SSSSSSSSSSS-------PP-------PXXXX---P---SQS--S?S--------SSSSS---PXX----P---PXXXXXXX-----P-----
-----------EP------------<>-----------PP----------<>---------E-----PXXX-------XX-XX--P-----------------------------------PP-P-----PXXXXX----P---------------E--E------PXXX-----P-PXXXXXXXX------P--P-
-------------P------------------------P-P-------------------<>----PXXXX-------XX-XXX--P----------------------------------P---P---PXXXXXX-----P---------------------E--PXXX------PXXXXXXXXX-------PP-P
--------------PPPPPPPPPPPPPPPPPPPPPPPP---PPPPPPPPPPPPPPPPPPPPPPPPPXXXX--------X--XXX--EPPPPPPPPPPPPPPPPPPPPPPPPPPPPPPPPPP-----PPPXXXXXXX-----EPPPPPPPPPPPPPPPPPPPPPPPPPXXX------XXXXXXXXXX-------XX--
XXXXXXXXXXXXXXXXXXXXXXXXXXXXXXXXXXXXXX---XXXXXXXXXXXXXXXXXXXXXXXXXXXXX--------X--XXXXXXXXXXXXXXXXXXXXXXXXXXXXXXXXXXXXXXXX----XXXXXXXXXX--XXXXXXXXXXXXXXXXXXXXXXXXXXXXXXXXX---XXXXXXXXXXXXXXXXXXXXXXXX
