-----------------------------------------------------------------------------------------------------------------PPP--------PP-------------------------------------------------------------
----------------------------------------------------------------------------------------------------------------PP--PPP----PP-P----------------------------PP------------------------------
--P-------------------------------------------------------------------------------------------------------------P------P---P---P---------------------------P-PPP--------------------------P
---P---------------------------------------------------------------PPPPPPPPPPPPPPPPPPPPPPPPPPPPPPPPPPPPPPPPPPPPP--------PPP-----PPPPPPPPPPPPPPPPPPPPPPPPPPP-XXX-PPPPPPPPPPPPPPPPPPPPPPPPPP-
S---P-SSSSSSSSSSSSSSSSSSSSSSSSSSSSSSSSSSSSSSSSSSSSSSSSSSS---------PSSSSSSSSSSSSSSSSSSSSSSSSSSSSSSSSSSSSSSSSSSSSS-------SSSS-----SSSSSSSSSSSSSSSSSSSSSSSSSSS-----SSSSSSSSSSSSSSSSSSSSSSSSSSS
S----P--------------SSSSSSSSSSSSSSSSSSSSSSSSSSSS------------------P---------------------------------------------------------------------------------------------SSSSSSSSSSSSSSSS-----------
S-----P-------------SSSSSSSSSSSSSSSSSSSSSSSSSSSS---------PPXXX--PPP-----------------------------------------------------?---------------------------------------SSSSSSSSSSSSSSSS-----------
S------P------------SSSSSSSSSSSSSSSSSSSSSSSSSSSS--QQ----PP-PPP-PSSS------------E---------------------------------------S??--------------------------------------SSSSSSSSSSSSSSSS-----E-----
S-------P---------------------------------------PP--P--PP-----PP--------------<>--------------------------------------------XXX---------------------------------S-------------------<>-----
S--------P------------------PP------------------P-P-PP-P-------PS-------------[]--------------------------------------------------------------------------------S-------------------[]-----
S---------P---------PPPPPPPP?-PPPPPPPPPPPPPPPPPP---P--P--------S-S------------[]-------S--------------------E----------------------------------E-----------------?oooooooooo--------[]-----
S----------P-------PP-SSSSSS??SSSSSSSSSSSSSSSSSS--QQ--QQQ---------S------E--SS[]SS---E----E----------------<>------XXX-SSSS----------------E--<>-----------------??SSSSSSSSS----XX--[]-----
S-----------P--P--PP--SSSSS---SSSSSSSSSSSSSSSSSS------------------------<>----[]----<>---<>-------------XX-[]--XXX------------------E-----<>--[]----------XX-------------------XXX--[]---SS
S------------P-PP-P---SSSSS---SSSSSSSSSSSSSSSSSS------------------------[]----[]----[]---[]------------XXX-[]--XXX-----------------<>-----[]--[]---------XXXXXX---------------XXXX--[]---SS
S-------------P--P---------oooSSSSSSSSSSSSSSSSSS------------------------[]-E--[]----[]---[]--------E-E-XXX-[]--XXX-----------------[]---E-[]--[]--------XXXX------------EE---XXXXX--[]---SS
XXXXXXXXXXX--XX--X---XXXXXXXXXXXXXXXXXXXXXXXXXXXXXXXXXXXX------XXXXXXXXXXXXXXXXXXXXXXXXXXXXXXXXXXXXXXXXXX--XX--XX------XXXX------XXXXXXXXXXXXXXX--XXXXXXXXX-----XXXXXXXXXXXXXXXXXXXXXXX--XX
