------------------------------------------------------------------------------------------------------------------------------------------------------
------------------------------------------------------------------------------------------------------------------------------------------------------
--P---------------------------------------------------------------------------------------------------------------------------------------------------
---P--------------------------------------PP-----------------------------------PP---------------------------------------------------------------------
----P---------------------------oo--------P-P---------------------------------PP-PPP------------------------------------------------------------------
-----P----------------------------PPPPPPPP---P-------------------------------PP-----P------------------------------------------------------P----------
------P--------------Eooo---------PXXXXXXX----P--------oooo----------PP------P-------P--oo--ooPP-----------PP---------------------------PPP-P---------
-------P-------------XXXXX--PP----P------------P-------XXXX---------PP-PPPPPP---oo----P------PP-PPP--------P-P-----oo-------------------PXX--P--------
--------P------------------PP-P---P----------oo-P------------------PP--XXXXXX----------P----PP-----PPPPPPPP---P----PP------XXX--------PP-XX---P-------
---------P-----------------P---PPP---------------P-----------------P--------------------P---P------XXXXXXXX----P---P-P----------------PXXXX----P------
----------P-------PPPPPPPPP---XXXXX---------------P-------------PPP--------------XXX-----PPP--------------------PPP---PPPP----------PP-XXXX-----P-----
-----------P-----PPXXXXXXXX------------------------PPPPP--------PXXX---------------------XXX-------------------XXXX--XXXX-P---------PXXXXXX------P----
------------P----P--------------------------------XXXX?-P-------P----------------------------------------------------------P--------PXXXXXX-------P-P-
-------------PPPP-----------o----------------------------P-P----P----------------------------XXXX---------------------------P-------PXXXXXX--------P-P
-------------XXXX----------XXX----------------------------P-PPPP--------------------------------------------ooo--------------PPPPPPP-XXXXXX--------X--
XXXXXXXXXXX----------------------------------XXXX-----XXXXX-XXXXX-------------------------------------------XXX-------------XXXXXXXXXXXXXXXXXXXXXXXXXX
