-------------------------------------------------------------------------------------------------------------------------------------------------------------------------------------------------------------------------------------------------------------------------------------------------------------------------------------------------------------------------------------
-------------------------------------------------------------------------------------------------------------------------------------------------------------------------------------------------------------------------------------------------------------------------------------------------------------------------------------------------------------------------------------
--P----------------------------------------------------------------------------------------------------------------------------------------------------------------------------------------------------------------------------------------------------------------------------------------------------------------------------------------------------------------------------------
---P---------------------------------------------------------------------------------------------------------------------------------------------------------------------------------------------------------------------------------------------------------------------------------------------------------------------------------------------------------------------------------
----P--------------------------------------------------------------------------------------------------------------------------------------------------------------------------------------------------------------------------------------------------------------------------------------------------------------------------------------------------------------------------------
-----P-------------------------------------------------------------------------------------------------------------------------------------------------------------------------------------------------------------------------------------------------------------------------------------------------------------------------------------------------------------------P-----------
------P-----------------------------------------------------------------------------------------------oo--------------------------------------------------------------------------------------------------------------------------------------------------------------------------------------------------------------------------------------------------------------PPP-P----------
-------P-------------------------------------------------------------------------------------------------------------------------------------------SSSSSSSS-----------------------------------------------------------------------------------------------------------------------------------------------------------------------------------------------------------PXX--P---------
--------P--------------------------------------------------------------PP--------------------------------------------------------------------------------------------------------------------------------------------------------------------PP----------------------------------PP---------------------------------------------------------------------------------PP-XX---P--------
---------P-------------------------------------------------------------P-PP--------------------------------------------------------------------------------------------------------------------------------------------------------------PP--P-PPP------------------------------PX-P--------------------------------------------------------------------------------PX-XX----P-------
----------P----------------PPP---------------------------o----------PPP--S-P------o---PPP--o----PPP---------------------------------------------PPP-------PPP--------------------SSSSSSSS-------------------------------PP---------------P-PP--<>-P----------------------------PXX--Po------o----o-------PP----------oo---oo----------------------------------PP--PP-X-XX-----P------
-----------P--------------PP<>PP------------------------------------P<>-----PP-------PP<>PP----PP<>PP--------------------------------PPP-------PP-XPP--S-PP-XPP--------------------------------------------------------PP-PPP---------PPP--<>--[]--P--------------------------PXXX---P-------------------P-P--------PP----PP---------------------PPP----------P-P-PX-X-XX------P-----
------------P------------PP-[]--P-----------------------------------P[]----<>-P-----PP-[]--P--PP-[]--P-----PPPP---------------------P<>-P-----PP--X--P--PP--X--P----E-------------------------------------PPP---------PP-----P-------PP<>--[]--[]---P------------------------PXXXX----P----PP---PP-----PP---PP-----PP-P--PP-P-------------------P<>-P------PPP---P-X-X-XX-------P----
-------------P-----------P--[]---P-----P-P--P--P--P-----------------P[]----[]--P----P--[]---P-P--[]---P----P<>-P--------------------P[]--P----P---X---P-P---X---P-P-P--PEP--P-----------------P-P-P-------PX-P--------P-------P------P-[]--[]--[]----P----------------------PXXXXX-----P---P-P--P-P----PX---X-P----P---P-P---P------------------P[]--P-----P<>---X-X-X-XX--------PP-P
--------------PPPPPPPPPPPE--[]----PPPPP-P-PP-PP-PP-PPPPPPPPPPPPPPPPP-[]----[]---PPPP---[]----P---[]-E-EPPPP-[]-EPPPPPPPPPPPPPPPPPPPPP[]---PPPPEE--X----P----X----P-P-PP-P-PP-PPPPPPPPPPPPPPPPP-P-P-PPPPPPP-X--PPPPPPPP---------PPPPPP--[]--[]--[]-----PPPPPPPPPPPPPPPPPPPPPPXXXXXX------PPP---PP---PPPP-X-E-X--PPPP-----P-----PPPPPPPPPPPPPPPPPPP[]---PPPPP-[]---X-X-X-XX--------X-P-
XXXXXXXXXXXXXXXXXXXXXXXXXXXXXXXXXXXXXXX-X-XX-XX-XX-XXXXXXXXXXXXXXXXXXXXXXXXXXXXXXXXXXXXXXXXXXXXXXXXXXXXXXXXXXXXXXXXXXXXXXXXXXXXXXXXXXXXXXXXXXXXXXXXXXXXXXXXXXXXXXX-X-XX-X-XX-XXXXXXXXXXXXXXXXX-X-X-XXXXXXXXXXXXXXXXXXX------XXXXXXXXXX-XX--XX--XXXXXXXXXXXXXXXXXXXXXXXXXXXXXXXXXXXXXXXXXXXX---XX---XXXXXXXXXXXXXXXX-----X----XXXXXXXXXXXXXXXXXXXXXXXXXXXXXXXXXXX-X-X-X-XXXXXXXXXXXXXX
