---------------------------------------------------------------------------------------------------------------------------------------------------------------------
-----------------------------------------------------------PP--------------------------------------------------------------------------------------------------------
--P------------------------------------------------PP-----PP-PPP------PP---------------------------------------------------------------------------------------------
---P-----------------------------------------------P-P---PP-----P----PP-PPP------------------------------------------------------------------------------------------
----P------------------oo------------P------PP----P---P--P-------P--PP-----P----ooo-------------------------------------------------------------------------------E--
-----P-------------------------------PP----PP-P--PQ----PP---------P-P-------P---XXXX-----------------------------------------------------------------oo--------------
------P--------------------------PPPP-oPooPPo--P-P-----XXX---------P---------P-------------------------------------------------------------PP------------------------
-------P---------------XXX------PP-XX---P-P-----PP----------------XXoo----XX--P------------------------------------XXX-----oo--XXXX--------P-PPP---PP--XXXX----------
--------P----------------------PP--------P------XX-----------------------------P------------------------------------------XX---PP------PPPP-XXX-P--P-P---------------
---------P---------------------P---------XX-------------------------------------P----------------------------------------------P-P-----PXXX-oo---PP---P--------------
----------P--------------PPPPPP--------------------------------------------------P---XXXX------oooo--PPPPPPPP---------------PPP---PPPPP---------XXX----P-------------
-----------P----XXXX----PPXXXXX-----------------------------XXXXXX----XX-----XX---PPPPP--------------PXXXXXX-P-----PP------PPXX---XXXXX-----------------P------------
------------P----PP----PP-------------------------------------------------------XXXXXX-P-------------P--------P---PP-P----PP-----------------------------P----------P
-------------P---P-P---P--------------------XXXXX---------------------------------------P--------P---P---------P--P---P---P-------------------------------P-------PP-
--------------PPP---PPP------------------------------------------------------------------PPPPPPPP-PPP-----------PP-----PPP---------------------------------PPPPPPPXX-
XXXXXXXXXXX--XXXX--XXXX---------XXXX--XXXX----------------------------------------------XXXXXXXXX-XXXX------XXXXXX----XXXX-----XXXX------------------------XXXXXXXXXX
