----------------------------------------------------------------------------------------------------------------------------------------------------------------------------------------
----------------------------------------------------------------------------------------------------------------------------------------------------------------------------------------
--P-------------------------------------------------------------------------------------------------------------------------------------------------------------------------------------
---P------------------------------------------------------------------------------------------------------------------------------------------------------------------------------------
----P----------------------------------------------------------------------------------PP-----------------------------------------------------------------------------------------------
-----P--------------------------------------------------------------------------------PP-P----------------------------------------------------------------------------------------------
------P-------------------------------------------------------------------------------P---P-----------------------------------------------------------------------------PPPPP-----------
-------P---------------------SS---------------------------------------------------PPPP-----P--------------S------------------------------------------------------------PPXXX-P----------
--------P------------------------------------------------------------------------PXSSS------P-----------------------------P------------------PPPP----------------------P-XXX--P---------
---------P---------------------------o-------------------------------oo--------PPXXX---------P-------------------------PPP-PPP--------------PXSS-Po-------------------P--XXX---P--------
----------PP----------------PPPPP--------------------------------PPPP----------PXXXS----------P---ooo-----------------PXSS-SQ-P------------PXXX---P------------------PXX-XXX----P-------
---------QQ-P------------PPPXXXX-PSSS------------------ooo------PXXX-P--------P-XXXX-----------PPP--------S----------PXXX------P----------PXXXX-SS-P----------------PXXX-XXX-----P------
-------------P--------PPPXXXXX----P---------------PP-----------PXXXX--P-----PPXXXXXX-SSS-------<>-P-----------------PXXXX-------P--------PXXXXX-----P--------PP----PXXXX-XXX------P-----
--------------P----PPPXXXXXX-------P--------------P-P---------PXXXXX---P----PXXXXXXX-----------[]--P---------------PXXXXX--------P------PXXXXXX--SSS-P-------P-P--PXXXXX-XXX-------PPP-P
---------------PPPPXXXXXXX----------PPPPPPPPPPPPPP---PPPPPPPPPXXXXXX----PPPP----XXXX-----------[]---PPPPPPPPPPPPPPPXXXXXX--SSSSS--PPPPPPXXXXXXX-------PPPPPPP---PPXXXXXX-XXX-------XX-P-
XXXXXXXXXXXXX--XXXXXXXXX------XX--XXXXXXXXXXXXXXXX--XXXXXXXXXXXXXXX---XXXXXXXXXXXXXXXX---XXXXXXXXXXXXXXXXXXXXXXXXXXXXXXX-------XX-XXXXXXXXXXXX------XXXXXXXXX---XXXXXXX--XXXXXXXXXXXXXXX
