------------------------------------------------------------------------------------------------------------------------------------------------------
------------------------------------------------------------------------------------------------------------------------------------------------------
--P---------------------------------------------------------------------------------------------------------------------------------------------------
---P--------------------------------------PP-----------------------------------PP---------------------------------------------------------------------
----P---------------------------oo--------P-P---------------------------------PP-PPP------------------------------------------------------------------
-----P----------------------------PPPPPPPP---P-------------------------------PP-----P------------------------------------------------------P----------
------P--------------Eooo---------PXXXXXXX----P--------oooo----------PP------P-------P--oo--oo-------------PP---------------------------PPP-P---------
-------P-------------XXXXX--PP----P------------P-------XXXX---------PP-PPPPPP---oo----P--------------------P-P-----oo-------------------PXX--P--------
--------P------------------PP-P---P----------oo-P------------------PP--XXXXXX----------P----------PPPPPPPPP---P----PP------XX---------PP-XX---P-------
---------P-----------------P---PPP---------------P-----------------P--------------------P--------PPXXXXXXXX----P---P-P----------------PXXXX----P------
----------P-------PPPPPPPPP---XXXXX---------------P-------------PPP--------------XX------PPP----PP--------------PPP---PPPP----------PP-XXXX-----P-----
-----------P-----PPXXXXXXXX------------------------PPP----------PXXX---------------------XX-P---P--------------XXXX--XXXX-P---------PXXXXXX------P----
------------P----P--------------------------------XXX-?---------P----------------------------PPP---------------------------P--------PXXXXXX-------P-P-
-------------PPPP-----------o-------------------------P----P----P----------------------------XXXX---------------------------P-------PXXXXXX--------P-P
-------------XXXX----------XXX-------------------------PPPP-PPPP--------------------------------------------ooo--------------PPPPPPP-XXXXXX--------X--
XXXXXXXXXXX----------------------------------XXXX-----XXXXX-XXXXX-------------------------------------------XXX-------------XXXXXXXXXXXXXXXXXXXXXXXXXX
