--------------------------------------------------------------------------------------------------------------------------------------------------------------
--------------------------------------------------------------------------------------------------------------------------------------------------------------
--P-----------------------------------------------------------------------------------------------------------------------------------------------------------
---P----------------------------------------------------------------------------------------------------------------------------------------------------------
S---P-SSSSSSSSSSSSSSSSSSSSSSSSSSSSSSSSSSSSSSSSSSSSSSSSSSSSSSSSSSSSSSSSSSSSSSSSSSSSSSSSSSS?SSSSSSSSSSSSSSSSSSSSSSSSSSSSSSSSSSSSSSSSSSSSSSSS--------------------
S----P------------------------------------------------SS--SSSSSS--SSSS------SSSS------------------------------------------------------------------------------
S-----P-----------------------------------------------SS--SSSSSS--SSSS--E---SSSS------------------------------------------------------------XXX---------------
S------P---------------------------------oooo-------SS--------SS---S----SS----------oooooo-----------------PP----------------------------------------------XXX
S-------P------------------PP-o---------------------SS--------SS---S----SS--------------------------------PP-PPP----------------------------------------------
S--------P-----------------P-PP--------S-SSSS-S-----SS--------SS---S----SS----------SSSSSS---------------PP-----P---------------------------------------------
S---------PPPPPP-------PPPP--S-P-------SoS--SoS-----SS----ooooSS---So??-SS---E------SSSSSS---------------P----E--P---------------------PPPPP-----SSSSS??------
S---------QQQQQ-P----PPXXXX-----PP-----SSS--SSS-----SSSS--SSSSSS---SSS--SS--SSSS-----------------------PP----<>---P------PPPP----------PXXX-PPPP--------------
S----------------P-PPXXXXXXXX--XX-PP------------------SS-------------------EE---PP--------------------P<>----[]----PPP--PPSS-P--------PEXXX-XXX-P--------PP---
S-----------------PXXXXXXXXXX--XXXX-P-----------------SS------------------------P-P-------------------P[]----[]----<>-P-P-SS--P------PXXXXX------P-------P-P-P
S-------------EE-XXXXXXXXXXXXE-XXXX--PPPPPPPPPPPPPPPPPPPPPPPPPPPPPPPPPPPPPPPPPPP---PPPPPPPPPPPPPPPPPPPP[]----[]--E-[]--P--SS---PPPPPPXXXXXX-------PPPPPPP---P-
XXXXXXXXXXXXXXXXXXXXXXXXXXXXXXXXXXXXXXXXXXXXXXXXXXXXXXXXXXXXXXXXXXXXXXXXXXXXXXXX---XXXXXXXXXXXXXXXXXXXXXXXXXXXXXXXXXXXXX--XX--XXXXXXXXXXXX-------XXXXXXXX--XXX
